1111111111111111111111111111111111
1000000000000001C10000C00000000001
1011110100100000001001000000010101
1011110010101010001001000100010101
1000000P0C00C000000000001C10000001
1011110100100000101001000000101011
1011110010101010E01001000000010101
1011110100100000101001000000010101
1011110010101010001001000000010101
1011110100100000101001000000010101
1011110010101010001001000000010101
1111111111111111111111111111111111
