111111111
101C10001
1P00010E1
100C00001
111111111
