111111111111111
10000010000C001
100C0000P010001
111111010011111
1E00000C0011111
111111111111111
