111111111
100C00001
1P0011101
100E1C001
111111111
