11111111111111111111111111111111111111111
11000000000000000011111111111111111111111
11111111111111111011111111111111111111111
11111111111111111011111111111111111111111
11111111111111111011111111111111111111111
11000000000011111011111111111111111111111
11111111111011111011111111111111111111111
11111111111011111011111111111111111111111
11111111111011111011111111111111111111111
11000011111011111011111111111111111111111
11111011111011111011111111111111111111111
11111011111011111011111111111111111111111
11111011111011111011111111111111111111111
11010PCCCCCCCCCCCCCCCCCCCCCCCCCCCCCCCCCE1
11011111011111011111111111111111111111111
11011111011111011111111111111111111111111
11111111011111011111111111111111111111111
11111111011111011111111111111111111111111
11111111011111011111111111111111111111111
11000000011111011111111111111111111111111
11111111111111011111111111111111111111111
11111111111111011111111111111111111111111
11111111111111011111111111111111111111111
11000000000000011111111111111111111111111
11111111111111111111111111111111111111111
11111111111111111111111111111111111111111
11111111111111111111111111111111111111111
